UUUUUUUUUUUUUUUUUUUUUUUUUUUUUUUUUUUUUUUUU
UUUUUUUUUUUUUUUUUUUUUUUUUUUUUUUUUUU  E  U
UUUUUUUUUUUUUUUUUUUUUUUUUUUUUUUUUUU     U
UUUUUUUUUUUUUUUUUUUUUUUUUUUUUUUUUUU     U
U             7      8       9          U
U                                       U
U         7   8    9                    U
U6   6RUUUUUUUUUUUUUUUUUUUUUUUUUUUUUUUUUU
U     RUUUUUUUUUUUUUUUUUUUUUUUUUUUUUUUUUU
U5   5RRRRRRRRRRRRUUUUUUUUUUUUUUUUUUUUUUU
U                 4     3              3U
U       P                               U
U                      4     3         3U
UUUUUXYYYYXUUUUUUUUUUUUUUUUUUUUUUUU     U
UUUUUXYYYYXUUUUUUUUUUUUUUUUUUUUUUUU     U
UUUUUXYYYYXUUUUUUUUUUUUUUUUUUUUUUUU     U
UUUUUXYYYYXUUUUUUU1   1     G      2   2U
UUUUUXYYYYXUUUUUUU1   1            2   2U
UUUUUXYYYYXXXXXXXX     UUUUUUUUUUUUUUUUUU
UUUUUXYYYYYYYYYYYY     UUUUUUUUUUUUUUUUUU
UUUUUXYYYYYYYYYYYY        UUUUUUUUUUUUUUU
UUUUUXYYYYYYYYYYYY        UUUUUUUUUUUUUUU
UUUUUXXXXXXXXXXXXX    A   UUUUUUUUUUUUUUU
UUUUUUUUUUUUUUUUUU        UUUUUUUUUUUUUUU
UUUUUUUUUUUUUUUUUUUUUUUUUUUUUUUUUUUUUUUUU