UUUUUUUUUUUUUUUUUUUUUUUUUUUUUUUUUUUUUUUU
U                                      U
U                                      U
U    3              P             3    U
U                                      U
U                                      U
U     XXXXXXXXYYYYYYYYYYXXXXXXXXXX     U
U     X                          X     U
U     Y                          X     U
U     Y      E     1         1   X     U
U     Y                          X     U
U     X                          Y     U
U     X                          Y     U
U     XXXXYYYYYXXXXYYXXXXXXF     Y     U
U                                Y     U
U                                X     U
U    2                     2     Y     U
U                                X     U
U                                X     U
UXXXXYYYYYYYYYXXXXXYYYYYYYYYYXXXXX     U
U                                      U
U                                      U
U     A          F          P          U
U                                      U
U                                      U
UUUUUUUUUUUUUUUUUUUUUUUUUUUUUUUUUUUUUUUU