UUUUUUUUUUUUUUUUUUUUUUUUUUUUUUUUUUUUUUUU
U   A                                  U
U                             1   1    U
URRRRRRRRRRRRRRRRRRRR                  U
U     R                           1    U
U     R                                U
U     R       FSRRRRRRRRRRRRRSSSSSSSSSSU
U     R                                U
U     S                                U
U     SSSSSSSSSSSSSSSSSSSSF     P      U
U                                      U
U   3                 3                U
U                          SSSSRRRRRRRRU
U                          S           U
U                          S     E     U
U                          S           U
U                          S           U
U            P             R           U
U                          R           U
U                          R           U
U                          R           U
U                          F           U
U                                      U
U   3                 3                U
U                                      U
UUUUUUUUUUUUUUUUUUUUUUUUUUUUUUUUUUUUUUUU