UUUUUUUUUUUUUUUUUUUUUUUUUUUUUUUUUUUUUU
U                                    U
U                                    U
U                                    U
U                                    U
U                                    U
U                                    U
U                                    U
U                                    U
U    E                       A       U
U                                    U
U                                    U
U                                    U
U                                    U
U                                    U
U                                    U
U                                    U
U                                    U
U                                    U
U                                    U
UUUUUUUUUUUUUUUUUUUUUUUUUUUUUUUUUUUUUU
