UUUUUUUUUUUUUUUUUUUUUUUUUUUUUUUUUUUUUU
U                                    U
U                                    U
U                                    U
U                                    U
U                                    U
U                                    U
U                 1                  U
U                                    U
U    E      1           1    A       U
U                                    U
U                                    U
U                 1                  U
U                                    U
U                                    U
U                                    U
U                                    U
U                                    U
U                                    U
U                                    U
UUUUUUUUUUUUUUUUUUUUUUUUUUUUUUUUUUUUUU
